####################
#\.=...............#
# ##################
# ...=.............#
# ##################
# .....=...........#
# ##################
# .......=.........#
# ##################
# .........=.......#
# ##################
# ...........=.....#
# ##################
# .............=...#
# ##################
# ...............=.#
# ##################
# oooooooooooooooo%#
####################
